##################l
#___m___+________#l
#_%______~~______#l
#_______________O#l
#_____T_________R#l
#___________G__G_#l
#_S________~~~~~~#l
#___RR~~~~ooooooo#l
##################l