##################l
#___m___+________#l
#_%______~~______#l
#_______________O#l
#_____T_________R#l
#___________G__G_#l
#_S________~~~~~~#l
#___RR~_~~ooooooo#l
#######d#######d##l
000000#TTTT#___T_#l
000000#TTTT#+___m#l
000000#TTTT#_____#l
000000############l