##################l
#___m___+________#l
#_%______~~______#l
#_______________O#l
#_____T__________#l
#___________G__G_#l
#_S_______o______#l
#_____~__________#l
##################l